#	0	1	2	3	4	5	6	7	8	9	10	11	12	13	14	15	16	17	18	19
m	1	2	1	1	1	1	1	1	1	3	1	4	6	6	1	1	6	6	6	6
m	1	0	S	1	2	1	2	0	0	0	1	0	E	6	0	E	6	C	C	6
m	3	0	0	1	0	0	0	0	0	E	0	0	0	6	0	0	6	C	C	6
m	1	0	2	1	0	1	1	0	0	0	1	0	0	5	0	0	6	0	0	6
m	1	0	1	0	0	0	3	0	0	0	3	1	2	1	0	1	6	6	0	6
m	1	0	3	0	0	E	1	1	0	1	1	0	0	0	0	1	0	0	0	6
m	1	0	2	0	0	0	1	0	0	0	1	0	1	0	0	1	0	E	0	6
m	1	0	1	0	0	0	2	0	E	0	2	0	1	0	0	2	0	0	0	6
m	2	0	0	0	0	0	1	0	0	0	1	0	1	0	E	6	E	0	0	6
m	1	3	1	2	1	1	1	0	0	0	0	0	2	0	1	6	0	0	0	6
m	1	0	0	0	E	1	1	1	2	1	1	3	1	0	2	1	4	E	0	6
m	1	0	E	0	0	2	0	0	0	0	0	0	0	0	1	1	1	1	0	6
m	2	0	0	0	0	1	0	1	1	0	1	1	1	1	3	1	5	4	0	6
m	1	2	1	0	3	1	0	3	1	E	1	0	0	0	0	0	0	6	0	6
m	1	0	0	0	0	0	0	1	1	1	2	0	0	1	1	2	0	6	0	6
m	3	0	0	0	0	1	0	2	4	5	1	0	E	1	0	0	0	6	0	6
m	1	1	0	1	3	1	0	1	0	0	1	0	0	2	0	0	0	6	0	5
m	1	0	0	E	0	2	0	0	0	0	0	0	0	1	0	E	0	0	0	2
m	1	0	0	0	0	1	0	1	0	0	1	0	0	1	0	0	0	6	0	4
m	1	1	2	3	1	1	2	1	1	2	1	2	3	1	2	1	6	6	6	6