#	0	1	2	3	4	5	6	7	8	9	10	11	12	13	14	15	16	17	18	19
m	1	1	1	1	1	1	1	1	1	1	1	1	1	1	1	1	1	1	1	1
m	1	0	S	1	1	1	1	0	0	0	1	0	E	1	0	E	1	C	C	1
m	1	0	0	1	0	0	0	0	0	E	0	0	0	1	0	0	1	C	C	1
m	1	0	1	1	0	1	1	0	0	0	1	0	0	1	0	0	1	C	C	1
m	1	0	1	0	0	0	1	0	0	0	1	1	1	1	0	1	1	1	0	1
m	1	0	1	0	0	E	1	1	0	1	1	0	0	0	0	1	0	0	0	1
m	1	0	1	0	0	0	1	0	0	0	1	0	1	0	0	1	0	E	0	1
m	1	0	1	0	0	0	1	0	E	0	1	0	1	0	0	1	0	0	0	1
m	1	0	0	0	0	0	1	0	0	0	1	0	1	0	E	1	E	0	0	1
m	1	1	1	1	1	1	1	0	0	0	0	0	1	0	1	1	0	0	0	1
m	1	0	0	0	E	1	1	1	1	1	1	1	1	0	1	1	1	E	0	1
m	1	0	E	0	0	1	0	0	0	0	0	0	0	0	1	1	1	1	0	1
m	1	0	0	0	0	1	0	1	1	0	1	1	1	1	1	1	1	1	0	1
m	1	1	1	0	1	1	0	1	1	E	1	0	0	0	0	0	0	1	0	1
m	1	0	0	0	0	0	0	1	1	1	1	0	0	1	1	1	0	1	0	1
m	1	0	0	0	0	1	0	1	1	1	1	0	E	1	0	0	0	1	0	1
m	1	1	0	1	1	1	0	1	0	0	1	0	0	1	0	0	0	1	0	1
m	1	0	0	E	0	1	0	0	0	0	0	0	0	1	0	E	0	0	0	1
m	1	0	0	0	0	1	0	1	0	0	1	0	0	1	0	0	0	1	0	1
m	1	1	1	1	1	1	1	1	1	1	1	1	1	1	1	1	1	1	1	1